## text ##
htm	text/html; charset=utf-8
html	text/html; charset=utf-8
css	text/css; charset=utf-8
txt	text/plain; charset=utf-8
text	text/plain; charset=utf-8
log	text/plain; charset=utf-8
csv	text/csv; charset=utf-8
xml	text/xml; charset=utf-8
vcf	text/vcard; charset=utf-8
vcard	text/vcard; charset=utf-8

## image ##
ico	image/x-icon
cur	application/octet-stream
bmp	image/bmp
png	image/png
gif	image/gif
tif	image/tiff
tiff	image/tiff
jpg	image/jpeg
jpe	image/jpeg
jpeg	image/jpeg
webp	image/webp
svg	image/svg+xml; charset=utf-8
svgz	image/svg+xml; charset=utf-8

## audio ##
aac	audio/x-aac
aif	audio/x-aiff
m3u	audio/x-mpegurl
wma	audio/x-ms-wma
mid	audio/midi
midi	audio/midi
mpga	audio/mpeg
mp4a	audio/mp4
oga	audio/ogg
ogg	audio/ogg
au	audio/basic
wav	audio/x-wav

## video ##
avi	video/x-msvideo
mp4	video/mp4
mpeg	video/mpeg

## font ##
otf	font/otf
ttf	font/ttf

## application ##
js	application/javascript; charset=utf-8
json	application/json; charset=utf-8
pdf	application/pdf
jar	application/java-archive
zip	application/zip
7z	application/x-7z-compressed
rar	application/x-rar-compressed
